1111111111111111111111111111111111111111111111111111111111111111111111111111111111111111111111111111
1111111111111111111111111111111111111111111111111111111111111111111111111111111111111111111111111111
1100000000000000000000000000000000000000000000000000000000000000000000000000000000000000000000000000
1100000000000000000000000000000000000000000000000000000000000000000000000000000000000000000000000000
1100000000000000000000000000000000000000000000000000000000000000000000000000000000000000000000000000
1100002222222222222222222222222222222222222222222222222222222222222222222222222222222222222222222222
1100000000000000000000000000000000000000000000000000000000000000000000000000000000000000000000000000
1100000000000000000000000000000000000000000000000000000000000000000000000000000000000000000000000000
1100000000000000000000000000000000000000000000000000000000000000000000000000000000000000000000000000
1100020001111111111111000200011111111111111111111111111111111111111111110002000111111111111111111111
1100020001111111111111000200011111111111111111111111111111111111111111110002000111111111111111111111
1100020001111111111111000200011111111000000111333333111000000111111111110002000111111111111111111111
1100020001111111111111000200011111111000000111333333111000000111111111110002000111111111111111111111
1100000000000000000000000000000000000000000000000000000000000000000000000000000000000000000000000000
1100000000000000000000000000000000000000000000000000000000000000000000000000000000000000000000000000
1100000000000000000000000000000000000000000000000000000000000000000000000000000000000000000000000000
1100002222222222222222000000022222222222222222222222222222222222222222220000000022222222222222222222
1100000000000000000000000000000C00000000000000000000000000000000000000000000000000000000000000000000
1100000000000000000000000000000000000000000000000000000000000000000000000000000000000000000000000000
1100000000000000000000000000000000000000000000000000000000000000000000000000000000000000000000000000
1100020001111111111111000200011111111000000111111111111111111111111111110002000111111111111111111111
1100020001111111111111000200011111111000000111111111111111111111111111110002000111111111111111111111
1100020001111111111111000200011111111111111111111111111111111111111111110002000111111111111111111111
1100020001111111111111000200011111111111111111111111111111111111111111110002000111111111111111111111
1100020001111111111111000200011111111111111111111111111111111111111111110002000111111111111111111111
1100020001111111111111000200011111111111111111111111111111111111111111110002000111111111111111111111
11000200011111111111110002000111111111111119P1111111111111111111111111110002000111111111111111111111
000000000000000000000000000000000000000000088S000000000000000000000000000000000000000000000000000000
000000000000000000000000000000000000000000088S000000000C00000000000000000000000000000000000000000000
0000000000222222222222000000022222222222222882222222222222222222222222220000000222222222222222222222
000000000000000000000000000000000000000000S880000000000000000000000000000000000000000000000000000000
000000000000000000000000000000000000000000S880000000000000000000000000000000000000000000000000000000
1111100020001111111111111111111111111111111111111111111111111111111111110002000111111111111111111111
1111100020001111111111111111111111111111111111111111111111111111111111110002000111111111111111111111
1111100020001111111111111111111111111111111111111111111111111111111111110002000111111111111111111111
1111100020001111111111111111111111111111111111111111111111111111111111111111111111111111111111111111
1111100000000000000000000000000000000000000000000000000000000000000000000000000000000000000000000000
1111100000000000000000000000000000000000000000000000000000000000000000000000000000000000000000000000
1111100000000000000000000000000000000000000000000000000000000000000000000000000000000000000000000000
1111100022222222222222222220000000002222222222222222222200000000022222222222222222222222222000000022
111110000000000000000C000000000000000000000000000000000000000000000000000000000000000000000000000000
1111100000000000000000000000000000000000000000000000000000000000000000000000000000000000000000000000
1111100000000000000000000000000000000000000000000000000000000000000000000000000000000000000000000000
1111111111111111111111111110000200001111111111111111111100002000011111111111111111111111111000200011
1111111111111111111111111110000200001111111111111111111100002000011111111111111111111111111000200011
1111111111111111111111111110000200001111111111111111111100002C00011111111111111111111111111000200011
1111111111111111111111111110000200001111111111111111111100002000011111111111111111111111111000200011
1111100000000000000000000000000000001111111111111111111100002000011111111111111111111111111000200011
1111100000000000000000000000000000001111111111111111111100002000011111111111111111111111111000200011
1111122222222222222222222220000000001111111111111111111100002000011111111111111111111111111000200011
1111100000000000000000000000000000001111111111111111111100002000011111111111111111111111111000200011
1111100000000000000000000000000000001111111111111111111100002000011111111111111111111111111000200011
1111111111110020011111111110000200001111111111111111111100002000011111111111111111111111111000200011
11111111111100200111111111100002000011111111111111111111SSSS2000011111111111111111111111111000200011
1111111111110020011111111110000200001111111111111111111988888888811111111111111111111111111000200011
1111111111110020011111111110000200001111111111111111111P88888888811111111111111111111111111000200011
1111111111110020011111111110000200001111111111111111111100002SSSS11111111111111111111111111000200011
1111111111110020011111111110000200001111111111111111111100002000011111111111111111111111111000200011
0000000000000000000000000000000000000000000000000000000000000000011111111111111111111111111000200011
0000000000000000000000000000000000000000000000000000000000000000011111111111111111111111111000200011
0000000000000000000000000000000000000000000000000000000000000000011111111111111111111111111000200011
0000000000000000000000000000000000000000000000000000000000000000011111111111111111111111111000200011
2220000000002222222222222220000000002222222222222222222200000000011111111111111111111111111SSS200011
0000000000000000000000000000000000000000000000000000000000000000011111111111111111111111119888888811
000000000000000000000000000000000000000000000000000000000000000001111111111111111111111111P888888811
00000000000000000000000000000000000000000000000000000000000000000111111111111111111111111110002SSS11
0000000000000000000000000000000000000000000000000000000000000000011111111111111111111111111000200011
1110000200001111111111111110000200001111111111111111111100002000011111111111111111111111111000200011
1110000200001111111111111110000200001111111111111111111100002000011111111113333333333333111000200011
1110000200004444411111111110000200001111111111111111111100002000011111111113333333333333000000200011
1110000200004444411111111110000200001111111111111111111100002000011111111113333333333333000000200011
1110000200004444411111111110000200001111111111111111111100002000011111111113333333333333000000200011
1110000200004444411111111110000200001111111111111111111100002000011111111113333333333333222222200011
1110000200001111111111111110000200001111111111111111111100002000011111111113333333333333000000000011
1110000200001111111111111110000200001111111111111111111100002000011111111113333333333333000000000011
0000000000000000000000000000000000000000000000000000000000002000011111111113333333333333000000000011
0000000000000000000000000000000000000000000000000000000000002000011111111113333333333333111111111111
0000000000000000000000000000000000000000000000000000000000002000011111111111111111111111111111111111
0000000000000000000000000000000000000000000000000000000000002000011111111111111111111111111111111111
2222222222222222000000022222222222222222222222222222222222222000011111111111111111111111111111111111
0000000000000000000000000000000000000000000000000000000000000000011111111111111111111111111111111111
0000000000000000000000000000000000000000000000000000000000000000011111111111111111111111111111111111
0000000000000000000000000000000000000000000000000000000000000000011111111111111111111111111111111111
0000000000000000000000000000000000000000000000000000000000000000011111111111111111111111111111111111
1110000200001111111111111100002000011111111111111111111111111111111111111111111111111111111111111111
1110000200001111111111111100002000011111111111111111111111111111111111111111111111111111111111111111
1110000200001111111111111100002000011111111111111111111111111111111111111111111111111111111111111111
11100002000011111111111111SSSS2000011111111111111111111111111111111111111111111111111111111111111111
1110000200001111111111111988888888811111111111111111111111111111111111111111111111111111111111111111
1110000200001111111111111P88888888811111111111111111111111111111111111111111111111111111111111111111
1110000200001111111111111100002SSSS11111111111111111111111111111111111111111111111111111111111111111
1110000200001111111111111100002000011111111111111111111111111111111111111111111111111111111111111111
1110000200001111111111111100002000011111111111111111111111111111111111111111111111111111111111111111
0000000000000000000000000000000000000000000000000000000000000000000000111111111111111111111111111111
0000000000000000000000000000000000000000000000000000000000000000000000111111111111111111111111111111
2220000000002222222222222200000000022222222222222222222222222222222000111111111111111111111111111111
0000000000000000000000000000000000000000000000000000000000000000000000111111111111111111111111111111
0000000000000000000000000000000000000000000000000000000000000000000000111111111111111111111111111111
1111111111111111111111111100002000011111111111111111111111111111111111111111111111111111111111111111
1111111111111111111111111100002000011111111111111111111111111111111111111111111111111111111111111111
1111111111111111111111111100000000011111111111111111111111111111111111111111111111111111111111111111
1111111111111111111111111100000000011111111111111111111111111111111111111111111111111111111111111111
