1111111111111111111111111111111111111111111111111111111111111111111111111111111111111111111111111111
1111111111111111111111111111111111111111111111111111111111111111111111111111111111111111111111111111
1100000000000000000000000000000000000000000000000000000000000000000000000000000000000000000000000000
1100000000000000000000000000000000000000000000000000000000000000000000000000000000000000000000000000
1100000000000000000000000000000000000000000000000000000000000000000000000000000000000000000000000000
1100002222222222222222222222222222222222222222222222222222222222222222222222222222222222222222222222
1100000000000000000000000000000000000000000000000000000000000000000000000000000000000000000000000000
1100000000000000000000000000000000000000000000000000000000000000000000000000000000000000000000000000
1100000000000000000000000000000000000000000000000000000000000000000000000000000000000000000000000000
1100020001111111111111000200011111111111111111111111111111111111111111110002000111111111111111111111
1100020001111111111111000200011111111111111111111111111111111111111111110002000111111111111111111111
1100020001111111111111000200011111111000000111333333111000000111111111110002000111111111111111111111
1100020001111111111111000200011111111000000111333333111000000111111111110002000111111111111111111111
1100000000000000000000000000000000000000000000000000000000000000000000000000000000000000000000000000
1100000000000000000000000000000000000000000000000000000000000000000000000000000000000000000000000000
1100000000000000000000000000000000000000000000000000000000000000000000000000000000000000000000000000
1100002222222222222222000000022222222222222222222222222222222222222222220000000022222222222222222222
1100000000000000000000000000000000000000000000000000000000000000000000000000000000000000000000000000
1100000000000000000000000000000000000000000000000000000000000000000000000000000000000000000000000000
1100000000000000000000000000000000000000000000000000000000000000000000000000000000000000000000000000
1100020001111111111111000200011111111000000111111111111111111111111111110002000111111111111111111111
1100020001111111111111000200011111111000000111111111111111111111111111110002000111111111111111111111
1100020001111111111111000200011111111111111111111111111111111111111111110002000111111111111111111111
1100020001111111111111000200011111111111111111111111111111111111111111110002000111111111111111111111
1100020001111111111111000200011111111111111111111111111111111111111111110002000111111111111111111111
1100020001111111111111000200011111111111111111111111111111111111111111110002000111111111111111111111
1100020001111111111111000200011111111111111911111111111111111111111111110002000111111111111111111111
0000000000000000000000000000000000000000000888888000000000000000000000000000000000000000000000000000
0000000000000000000000000000000000000000000888888000000000000000000000000000000000000000000000000000
0000000000222222222222000000022222222222222888888222222222222222222222220000000222222222222222222222
0000000000000000000000000000000000000000000888888000000000000000000000000000000000000000000000000000
0000000000000000000000000000000000000000000888888000000000000000000000000000000000000000000000000000
1111100020001111111111111111111111111111111111111111111111111111111111110002000111111111111111111111
1111100020001111111111111111111111111111111111111111111111111111111111110002000111111111111111111111
1111100020001111111111111111111111111111111111111111111111111111111111110002000111111111111111111111
1111100020001111111111111111111111111111111111111111111111111111111111111111111111111111111111111111
1111100000000000000000000000000000000000000000000000000000000000000000000000000000000000000000000000
1111100000000000000000000000000000000000000000000000000000000000000000000000000000000000000000000000
1111100000000000000000000000000000000000000000000000000000000000000000000000000000000000000000000000
1111100022222222222222222220000000002222222222222222222222000000000222222222222222222222222222200000
1111100000000000000000000000000000000000000000000000000000000000000000000000000000000000000000000000
1111100000000000000000000000000000000000000000000000000000000000000000000000000000000000000000000000
1111100000000000000000000000000000000000000000000000000000000000000000000000000000000000000000000000
1111111111111111111111111110000200001111111111111111111100002000011111111111111111111111111110002000
1111111111111111111111111110000200001111111111111111111100002000011111111111111111111111111110002000
1111111111111111111111111110000200001111111111111111111100002000011111111111111111111111111110002000
1111111111111111111111111110000200001111111111111111111100002000011111111111111111111111111110002000
1111100000000000000000000000000000001111111111111111111100002000011111111111111111111111111110002000
1111100000000000000000000000000000001111111111111111111100002000011111111111111111111111111110002000
1111122222222222222222222222222200001111111111111111111100002000011111111111111111111111111110002000
1111100000000000000000000000000000001111111111111111111100002000011111111111111111111111111110002000
1111100000000000000000000000000000001111111111111111111100002000011111111111111111111111111110002000
1111111111110020011111111110000200001111111111111111111100002000011111111111111111111111111110002000
1111111111110020011111111110000200001111111111111111111100002000011111111111111111111111111110002000
1111111111110020011111111110000200001111111111111111111988888888811111111111111111111111111110002000
1111111111110020011111111110000200001111111111111111111188888888811111111111111111111111111110002000
1111111111110020011111111110000200001111111111111111111100002000011111111111111111111111111110002000
1111111111110020011111111110000200001111111111111111111100002000011111111111111111111111111110002000
0000000000000000000000000000000000000000000000000000000000002000011111111111111111111111111110002000
0000000000000000000000000000000000000000000000000000000000002000011111111111111111111111111110002000
0000000000000000000000000000000000000000000000000000000000002000011111111111111111111111111110002000
0000000000000000000000000000000000000000000000000000000000002000011111111111111111111111111110002000
2220000000002222222222222220000000002222222222222222222200002000011111111111111111111111111110002000
2220000000002222222222222220000000002222222222222222222200002000011111111111111111111111111198888888
0000000000000000000000000000000000000000000000000000000000002000011111111111111111111111111118888888
0000000000000000000000000000000000000000000000000000000000002000011111111111111111111111111110002000
0000000000000000000000000000000000000000000000000000000000002000011111111111111111111111111110002000
1110000200001111111111111110000200001111111111111111111100002000011111111111111111111111111110002000
1110000200001111111111111110000200001111111111111111111100002000011111111113333333333333111110002000
1110000200004444411111111110000200001111111111111111111100002000011111111113333333333333000000002000
1110000200004444411111111110000200001111111111111111111100002000011111111113333333333333000000002000
1110000200004444411111111110000200001111111111111111111100002000011111111113333333333333000000002000
1110000200004444411111111110000200001111111111111111111100002000011111111113333333333333222222222000
1110000200001111111111111110000200001111111111111111111100002000011111111113333333333333000000000000
1110000200001111111111111110000200001111111111111111111100002000011111111113333333333333000000000000
0000000000000000000000000000000000000000000000000000000000002000011111111113333333333333000000000000
0000000000000000000000000000000000000000000000000000000000002000011111111113333333333333111111111111
0000000000000000000000000000000000000000000000000000000000002000011111111111111111111111111111111111
0000000000000000000000000000000000000000000000000000000000002000011111111111111111111111111111111111
2222222222222222000000022222222222222222222222222222222222222000011111111111111111111111111111111111
0000000000000000000000000000000000000000000000000000000000000000011111111111111111111111111111111111
0000000000000000000000000000000000000000000000000000000000000000011111111111111111111111111111111111
0000000000000000000000000000000000000000000000000000000000000000011111111111111111111111111111111111
0000000000000000000000000000000000000000000000000000000000000000011111111111111111111111111111111111
1110000200001111111111111100002000011111111111111111111111111111111111111111111111111111111111111111
1110000200001111111111111100002000011111111111111111111111111111111111111111111111111111111111111111
1110000200001111111111111100002000011111111111111111111111111111111111111111111111111111111111111111
1110000200001111111111111100002000011111111111111111111111111111111111111111111111111111111111111111
1110000200001111111111111988888888811111111111111111111111111111111111111111111111111111111111111111
1110000200001111111111111188888888811111111111111111111111111111111111111111111111111111111111111111
1110000200001111111111111100002000011111111111111111111111111111111111111111111111111111111111111111
1110000200001111111111111100002000011111111111111111111111111111111111111111111111111111111111111111
1110000200001111111111111100002000011111111111111111111111111111111111111111111111111111111111111111
0000000000000000000000000000000000000000000000000000000000000000000000111111111111111111111111111111
0000000000000000000000000000000000000000000000000000000000000000000000111111111111111111111111111111
2222222222222222222222222222222222222222222222222222222222222222222222111111111111111111111111111111
0000000000000000000000000000000000000000000000000000000000000000000000111111111111111111111111111111
0000000000000000000000000000000000000000000000000000000000000000000000111111111111111111111111111111
1111111111111111111111111100002000011111111111111111111111111111111111111111111111111111111111111111
1111111111111111111111111100002000011111111111111111111111111111111111111111111111111111111111111111
1111111111111111111111111100002000011111111111111111111111111111111111111111111111111111111111111111
1111111111111111111111111100002000011111111111111111111111111111111111111111111111111111111111111111
